あ	a
か	ka
さ	sa
た	ta
な	na
は	ha
ま	ma
や	ya
ら	ra
わ	wa
ん	n
い	i
き	ki
し	shi
ち	chi
に	ni
ひ	hi
み	mi
り	ri
う	u
く	ku
す	su
っ	っ
つ	tsu
ぬ	nu
ふ	fu
む	mu
ゆ	yu
る	ru
え	e
け	ke
せ	se
て	te
ね	ne
へ	he
め	me
れ	re
お	o
こ	ko
そ	so
と	to
の	no
ほ	ho
も	mo
よ	yo
ろ	ro
を	wo
が	ga
ざ	za
だ	da
ば	ba
ぎ	gi
じ	ji
ぢ	ji
び	bi
ぐ	gu
ず	zu
づ	zu
ぶ	bu
げ	ge
ぜ	ze
で	de
べ	be
ご	go
ぞ	zo
ど	do
ぼ	bo
ぱ	pa
ぴ	pi
ぷ	pu
ぺ	pe
ぽ	po
きゃ	kya
ぎゃ	gya
しゃ	sha
じゃ	jya
ちゃ	cha
ぢゃ	dya
にゃ	nya
ひゃ	hya
びゃ	bya
ぴゃ	pya
みゃ	mya
りゃ	rya
きゅ	kyu
ぎゅ	gyu
しゅ	shu
じゅ	jyu
ちゅ	chu
ぢゅ	dyu
にゅ	nyu
ひゅ	hyu
びゅ	byu
ぴゅ	pyu
みゅ	myu
りゅ	ryu
きょ	kyo
ぎょ	gyo
しょ	sho
じょ	jyo
ちょ	cho
ぢょ	dyo
にょ	nyo
ひょ	hyo
びょ	byo
ぴょ	pyo
みょ	myo
りょ	ryo